#############
#           #
# @$$     ..#
#           #
#           #
#############
